365,405,0,405,0,405,365,405
405,405,0,405,0,405,0,0
405,365,365,405,405,365,405,0
0,405,405,0,365,0,365,405
405,365,405,405,405,405,405,0
0,405,405,405,365,1160,1161,1161
405,0,405,405,405,1200,1361,1361
405,405,405,0,405,1200,1361,1361
